05 05 05 05 05 05 05 05 05 05 05 05 05 05 05 05 05 05 05 05 05 05 05 05 05 05 05 05 05 05 05 05 05 05 05 05 05 05 05 05 05 05 05 05 05 05 05 05 05 05 05 05 05 05 05
05 05 05 05 05 05 05 05 05 05 05 05 05 05 05 05 05 05 05 05 05 05 05 05 05 05 05 05 05 05 05 05 05 05 05 05 05 05 05 05 05 05 05 05 05 05 05 05 05 05 05 05 05 05 05
05 05 05 05 05 05 05 05 05 05 05 05 05 05 05 05 05 05 05 05 05 05 05 05 05 05 05 05 05 05 05 05 05 05 05 05 05 05 05 05 05 05 05 05 05 05 05 05 05 05 05 05 05 05 05
05 05 05 05 29 29 29 29 29 29 29 29 29 29 29 29 29 29 29 29 29 29 29 29 29 29 29 29 29 29 29 29 29 29 29 29 29 29 29 29 29 29 29 29 29 29 29 29 29 29 05 05 05 05 05
05 05 05 05 30 30 30 30 30 30 30 30 30 30 30 30 30 30 30 30 30 30 30 30 30 30 30 30 30 30 30 30 30 30 30 30 30 30 30 30 30 30 30 30 30 30 30 30 30 30 05 05 05 05 05
05 05 05 05 10 10 10 10 10 10 10 10 10 10 10 10 10 10 10 10 10 10 10 10 10 10 10 10 10 10 10 10 10 10 10 10 10 10 10 10 10 10 10 10 10 10 10 10 10 10 05 05 05 05 05
05 05 05 05 10 10 10 10 10 10 10 10 10 10 10 10 10 10 10 10 10 10 10 10 10 10 10 10 10 10 10 10 10 10 10 10 10 10 10 10 10 10 10 10 10 10 10 10 10 10 05 05 05 05 05
05 05 05 05 10 10 10 10 10 10 10 10 10 10 10 10 10 10 10 10 05 05 05 05 05 05 05 05 05 05 05 05 05 05 05 05 05 05 05 05 05 05 05 05 05 10 10 10 10 10 05 05 05 05 05
05 05 05 05 10 10 10 10 10 10 10 10 10 10 10 10 10 10 10 10 05 05 05 05 05 05 05 05 05 05 05 05 05 05 05 05 05 05 05 05 05 05 05 05 05 10 10 10 10 10 05 05 05 05 05
05 05 05 05 10 10 10 10 10 10 10 10 10 10 10 10 10 10 10 10 05 05 05 05 05 05 05 05 05 81 05 05 05 05 05 05 05 05 05 05 05 05 05 05 05 10 10 10 10 10 05 05 05 05 05
05 05 05 05 10 10 10 10 10 10 10 10 10 10 10 10 10 10 10 10 05 05 05 22 23 10 10 10 10 10 10 10 10 10 10 10 10 10 10 10 10 10 10 10 10 10 10 10 10 10 05 05 05 05 05
05 05 05 05 10 10 10 10 10 10 10 10 10 10 10 10 10 10 10 10 05 05 05 24 25 10 10 10 10 10 10 10 10 10 10 10 10 10 10 10 10 10 10 10 10 10 10 10 10 10 05 05 05 05 05
05 05 05 05 10 10 10 10 10 10 10 10 10 10 10 10 10 10 10 10 05 05 05 26 27 10 10 10 10 10 10 10 10 10 10 10 10 10 10 10 10 10 10 10 10 10 10 10 10 10 05 05 05 05 05
05 05 05 05 10 10 10 10 10 10 10 10 10 10 10 10 10 10 10 10 05 05 05 10 10 10 10 10 10 10 10 10 10 10 10 10 10 10 10 10 10 10 10 10 10 10 10 10 10 10 05 05 05 05 05
05 05 05 05 10 10 10 10 10 10 10 10 10 10 10 10 10 10 10 10 05 05 05 22 23 10 10 10 10 10 10 10 10 10 10 10 10 10 10 10 10 10 10 10 10 10 10 10 10 10 05 05 05 05 05
05 05 05 05 10 10 10 10 10 10 10 10 10 10 10 10 10 10 10 10 05 05 05 24 25 10 10 10 10 10 10 10 10 10 10 10 10 10 10 10 10 10 10 10 10 10 10 10 10 10 05 05 05 05 05
05 05 05 05 10 10 10 10 10 10 10 10 10 10 10 10 10 10 10 10 05 05 05 26 27 10 10 10 10 10 10 10 10 10 10 10 10 10 10 10 10 10 10 10 10 10 10 10 10 10 05 05 05 05 05
05 05 05 05 05 05 05 05 05 05 05 05 05 05 05 05 05 10 10 10 05 05 05 10 10 10 10 10 10 10 10 10 10 10 10 10 10 10 10 10 10 10 10 10 10 10 10 10 10 10 05 05 05 05 05
05 05 05 05 05 05 05 05 05 05 05 05 05 05 05 05 05 10 10 10 05 05 05 05 05 05 05 05 05 05 05 05 05 05 05 05 05 05 05 05 05 05 05 05 05 05 05 05 05 05 05 05 05 05 05
05 05 05 05 05 05 05 05 05 05 05 05 05 05 05 05 05 10 10 10 05 05 05 05 05 05 05 05 05 05 05 05 05 05 05 05 05 05 05 05 05 05 05 05 05 05 05 05 05 05 05 05 05 05 05
05 05 05 05 05 05 05 05 05 05 05 05 05 05 05 05 05 10 10 10 05 05 05 05 05 05 05 05 05 05 05 05 05 05 05 05 05 05 05 05 05 05 05 05 05 05 05 05 05 05 05 05 05 05 05
05 05 05 05 05 05 05 05 05 05 05 05 05 05 05 05 05 10 10 10 05 05 05 05 05 05 05 05 05 05 05 05 05 05 05 05 05 05 05 05 05 05 05 05 05 05 05 05 05 05 05 05 05 05 05
05 05 05 05 22 23 10 10 10 10 10 10 10 10 10 10 10 10 10 10 10 10 10 10 10 10 10 10 10 10 10 10 10 10 10 10 10 10 10 10 10 10 10 10 10 10 10 10 10 10 05 05 05 05 05
05 05 05 05 24 25 10 10 10 10 10 10 10 10 10 10 10 10 10 10 10 10 10 10 10 10 10 10 10 10 10 10 10 10 10 10 10 10 10 10 10 10 10 10 10 10 10 10 10 10 05 05 05 05 05
05 05 05 05 26 27 10 10 10 10 10 10 10 10 10 10 10 10 10 10 10 10 10 10 10 10 10 10 10 10 10 10 10 10 10 10 10 10 10 10 10 10 10 10 10 10 10 10 10 10 05 05 05 05 05
05 05 05 05 10 10 10 10 10 10 10 10 10 10 10 10 10 10 10 10 10 10 10 10 10 10 10 10 10 10 10 10 10 10 10 10 10 10 10 10 10 10 10 10 10 10 10 10 10 10 05 05 05 05 05
05 05 05 05 05 05 05 05 05 05 05 05 05 05 05 05 05 05 05 05 05 05 05 05 05 05 05 05 05 05 10 10 10 10 10 10 10 10 10 10 10 10 10 10 10 10 10 10 10 10 05 05 05 05 05
05 05 05 05 05 05 05 05 05 05 05 05 05 05 05 05 05 05 05 05 05 05 05 05 05 05 05 05 05 05 10 10 10 10 10 10 10 10 10 10 10 10 10 10 10 10 10 10 10 10 05 05 05 05 05
05 05 05 05 05 05 05 05 05 05 05 05 05 05 05 05 05 05 05 05 05 05 05 05 05 05 05 05 05 05 10 10 10 10 10 10 10 10 10 10 10 10 10 10 10 10 10 10 10 10 05 05 05 05 05
05 05 05 05 05 05 05 05 05 05 05 05 05 05 05 05 05 05 05 05 05 05 05 05 05 05 05 05 05 05 10 10 10 10 10 10 10 10 10 10 10 10 10 10 10 10 10 10 10 10 05 05 05 05 05
05 05 05 05 05 05 05 05 05 05 05 05 05 05 05 05 05 05 05 05 05 05 05 05 05 05 05 05 05 05 10 10 10 10 10 10 10 10 10 10 10 10 10 10 10 10 10 10 10 10 05 05 05 05 05
05 05 05 05 29 29 29 29 29 29 29 29 29 29 29 29 29 29 29 29 29 29 29 29 29 29 29 29 29 29 10 10 10 10 10 29 05 76 05 05 22 23 10 10 10 10 10 10 22 23 05 05 05 05 05
05 05 05 05 30 30 30 30 30 30 30 30 30 30 30 30 30 30 30 30 30 30 30 30 30 30 30 30 30 30 10 10 10 10 10 30 05 76 05 05 24 25 10 10 10 10 10 10 24 25 05 05 05 05 05
05 05 05 05 29 10 10 10 10 10 10 10 10 10 10 10 10 10 10 10 10 10 10 10 10 10 10 10 10 10 10 10 10 10 10 29 05 76 05 05 26 27 10 10 10 10 10 10 26 27 05 05 05 05 05
05 05 05 05 30 10 18 19 10 10 10 10 10 10 10 10 10 10 10 10 10 10 10 10 10 10 10 10 10 10 10 10 10 10 10 30 05 76 05 05 22 23 10 10 10 10 10 10 22 23 05 05 05 05 05
05 05 05 05 29 10 20 21 10 10 10 10 10 10 10 10 10 10 10 10 10 10 10 10 10 10 10 10 10 10 10 10 10 10 10 29 05 76 05 05 24 25 10 10 10 10 10 10 24 25 05 05 05 05 05
05 05 05 05 30 10 10 16 10 10 10 10 10 10 10 10 10 10 10 10 10 10 10 10 10 10 10 10 10 10 10 10 10 10 10 30 05 76 05 05 26 27 10 10 10 10 10 10 26 27 05 05 05 05 05
05 05 05 05 29 10 10 17 10 10 10 10 10 10 10 10 10 10 10 10 10 10 10 10 10 10 10 10 10 10 10 10 10 10 10 29 05 76 05 05 22 23 10 10 10 10 10 10 22 23 05 05 05 05 05
05 05 05 05 30 10 10 10 28 11 10 10 10 10 10 10 10 10 10 10 10 10 10 10 10 10 10 10 10 10 10 10 10 10 10 30 05 76 05 05 24 25 10 10 10 10 10 10 24 25 05 05 05 05 05
05 05 05 05 29 10 10 10 12 13 10 10 10 10 10 10 10 10 10 10 10 10 10 10 10 10 10 10 10 10 10 10 10 10 10 29 05 76 05 05 26 27 10 10 10 10 10 10 26 27 05 05 05 05 05
05 05 05 05 30 10 10 10 14 15 10 10 10 10 10 10 10 10 10 10 10 10 10 10 10 10 10 10 10 10 10 10 10 10 10 30 05 76 05 05 22 23 10 10 10 10 10 10 22 23 05 05 05 05 05
05 05 05 05 29 10 10 10 10 10 10 10 10 10 10 10 10 10 10 10 10 10 10 10 10 10 10 10 10 10 10 18 19 10 10 10 05 76 05 05 24 25 10 10 10 10 10 10 24 25 05 05 05 05 05
05 05 05 05 30 10 10 10 10 10 10 10 10 10 10 10 10 10 10 10 10 10 10 10 10 10 10 10 10 10 10 20 21 10 10 10 05 76 05 05 26 27 10 10 10 10 10 10 26 27 05 05 05 05 05
05 05 05 05 29 10 10 10 10 10 10 10 10 10 10 10 10 10 10 10 10 10 10 10 10 10 10 10 10 10 10 10 16 10 28 11 05 76 05 05 22 23 10 10 10 10 10 10 22 23 05 05 05 05 05
05 05 05 05 30 10 10 10 10 10 10 10 10 10 10 10 10 10 10 10 10 10 10 10 10 10 10 10 10 10 10 10 17 10 12 13 05 76 05 05 24 25 10 10 10 10 10 10 24 25 05 05 05 05 05
05 05 05 05 29 10 10 10 10 10 10 10 10 10 10 10 10 10 10 10 10 10 10 10 10 10 10 10 10 10 10 10 10 10 14 15 05 76 05 05 26 27 10 10 10 10 10 10 26 27 05 05 05 05 05
05 05 05 05 30 10 10 10 10 10 10 10 10 10 10 10 10 10 10 10 10 10 10 10 10 10 10 10 10 10 10 10 10 10 10 10 05 76 05 05 22 23 10 10 10 10 10 10 22 23 05 05 05 05 05
05 05 05 05 29 10 10 10 10 10 10 10 10 10 10 10 10 10 10 10 10 10 10 10 10 10 10 10 10 10 10 10 10 10 10 77 79 78 05 05 24 25 10 10 10 10 10 10 24 25 05 05 05 05 05
05 05 05 05 30 10 10 10 10 10 10 10 10 10 10 10 10 10 10 10 10 10 10 10 10 10 10 10 10 10 10 10 10 10 10 80 05 76 05 05 26 27 10 10 10 10 10 10 26 27 05 05 05 05 05
05 05 05 05 29 10 10 10 10 10 10 10 10 10 10 10 10 10 10 10 10 10 10 10 10 10 10 10 10 10 10 10 58 59 60 61 05 76 05 05 22 23 10 10 10 10 10 10 22 23 05 05 05 05 05
05 05 05 05 30 10 10 10 10 10 10 10 10 10 10 10 10 10 10 10 10 10 10 10 10 10 10 10 10 10 10 62 63 64 65 66 05 76 05 05 24 25 10 10 10 10 10 10 24 25 05 05 05 05 05
05 05 05 05 29 10 10 10 10 10 10 10 10 10 10 10 10 10 10 10 10 10 10 10 10 10 10 10 10 10 10 67 68 69 70 71 05 76 05 05 26 27 10 10 10 10 10 10 26 27 05 05 05 05 05
05 05 05 05 30 10 10 10 10 10 10 10 10 10 10 10 10 10 10 10 10 10 10 10 10 10 10 10 10 10 10 72 73 74 75 63 05 76 05 05 22 23 10 10 10 10 10 10 22 23 05 05 05 05 05
05 05 05 05 29 10 10 10 10 10 10 10 10 10 10 10 10 10 10 10 10 10 10 10 10 10 10 10 10 10 10 70 65 64 62 69 05 05 05 05 24 25 10 10 10 10 10 10 24 25 05 05 05 05 05
05 05 05 05 30 29 29 29 29 29 29 29 29 29 29 29 29 29 29 29 29 29 29 29 29 29 29 29 29 29 29 29 29 29 29 10 05 05 05 05 26 27 10 10 10 10 10 10 26 27 05 05 05 05 05
05 05 05 05 10 30 30 30 30 30 30 30 30 30 30 30 30 30 30 30 30 30 30 30 30 30 30 30 30 30 30 30 30 30 30 10 05 05 05 05 10 10 10 10 10 10 10 10 10 10 05 05 05 05 05
05 05 05 05 05 05 05 05 05 05 05 05 05 05 05 05 05 05 05 05 05 05 05 05 05 05 05 05 05 05 05 05 05 05 05 10 05 05 05 05 05 05 05 05 05 05 05 05 05 05 05 05 05 05 05
05 05 05 05 05 05 05 05 05 05 05 05 05 05 05 05 05 05 05 05 05 05 05 05 05 05 05 05 05 05 05 05 05 05 05 05 05 05 05 05 05 05 05 05 05 05 05 05 05 05 05 05 05 05 05
05 05 05 05 05 05 05 05 05 05 05 05 05 05 05 05 05 05 05 05 05 05 05 05 05 05 05 05 05 05 05 05 05 05 05 05 05 05 05 05 05 05 05 05 05 05 05 05 05 05 05 05 05 05 05
05 05 05 05 05 05 05 05 05 05 05 05 05 05 05 05 05 05 05 05 05 05 05 05 05 05 05 05 05 05 05 05 05 05 05 05 05 05 05 05 05 05 05 05 05 05 05 05 05 05 05 05 05 05 05
