05 05 05 05 05 05 05 05 05 05 05 05 05 05 05 05 05 05 05 05 05 05 05 05 05 05 05 05 05 05 05 05 05 05 05 05 05 05 05 05 05 05 05 05 05 05 05 05 05 05 05 05 05 05 05
05 05 05 05 05 05 05 05 05 05 05 05 05 05 05 05 05 05 05 05 05 05 05 05 05 05 05 05 05 05 05 05 05 05 05 05 05 05 05 05 05 05 05 05 05 05 05 05 05 05 05 05 05 05 05
05 05 05 05 05 35 39 39 35 05 05 05 05 05 05 05 05 05 05 05 05 05 05 05 05 05 05 05 05 05 05 05 05 05 05 05 05 05 05 05 05 05 05 05 05 05 05 05 05 05 05 05 05 05 05
05 05 05 05 05 35 39 39 35 05 05 05 05 05 05 05 05 05 05 05 05 05 05 05 05 05 05 05 05 05 05 05 05 05 05 05 05 05 05 05 05 05 05 05 05 05 05 05 05 05 05 05 05 05 05
05 05 05 05 05 35 39 39 35 05 05 05 05 05 05 05 05 05 05 05 05 05 05 05 05 05 05 05 05 05 05 05 05 05 05 05 05 05 05 05 05 05 05 05 05 05 05 05 05 05 05 05 05 05 05
05 05 05 05 05 35 39 39 35 05 05 05 05 05 05 05 05 05 05 05 05 05 05 05 05 05 05 05 05 05 05 05 05 05 05 05 05 05 05 05 05 05 05 05 05 05 05 05 05 05 05 05 05 05 05
05 05 05 05 05 35 39 39 35 05 05 05 05 05 35 35 35 35 35 35 35 35 35 35 35 35 35 35 35 35 35 35 35 35 35 35 35 35 35 35 35 35 35 35 35 35 35 35 35 35 05 05 05 05 05
05 05 05 05 05 35 39 39 35 05 05 05 05 05 35 50 39 39 39 39 39 39 39 39 39 39 39 39 39 39 39 39 39 39 39 39 39 39 39 39 39 39 39 39 39 39 39 39 50 35 05 05 05 05 05
05 05 05 05 05 35 39 39 35 05 05 05 05 05 35 51 39 39 39 39 39 39 39 39 39 39 39 39 39 39 39 39 39 39 39 39 39 39 39 39 39 39 39 39 39 39 39 39 51 35 05 05 05 05 05
05 05 05 05 05 35 39 39 35 35 35 35 35 35 35 39 39 39 39 39 39 39 39 39 39 39 39 39 39 39 39 39 39 39 39 39 39 39 39 39 39 39 39 39 39 39 39 39 39 35 05 05 05 05 05
05 05 05 05 05 35 39 39 39 39 39 39 39 39 39 39 39 39 39 39 39 39 39 39 39 39 39 39 39 39 39 39 39 39 39 39 39 39 39 39 39 39 39 39 39 39 39 39 39 35 05 05 05 05 05
05 05 05 05 05 35 39 39 39 39 39 39 39 39 39 39 39 39 39 39 39 39 39 39 39 39 39 39 39 39 39 39 39 39 39 39 39 39 39 39 39 39 39 39 39 39 39 39 39 35 05 05 05 05 05
05 05 05 05 05 35 35 35 35 35 35 35 35 35 35 35 35 35 35 35 35 35 35 35 35 35 35 35 35 35 35 35 35 35 35 35 35 35 35 35 35 35 35 39 39 39 39 39 39 35 05 05 05 05 05
05 05 05 05 05 05 05 05 05 05 05 05 05 05 05 05 05 05 05 05 05 05 05 05 05 05 05 05 05 05 05 05 05 05 05 05 05 05 05 05 05 05 35 39 39 39 39 39 39 35 05 05 05 05 05
05 05 05 05 05 05 05 05 05 05 05 05 05 05 05 05 05 05 05 05 05 05 05 05 05 05 05 05 05 05 05 05 05 05 05 05 05 05 05 05 05 05 35 39 39 39 39 39 39 35 05 05 05 05 05
05 05 05 05 05 05 05 05 05 05 05 05 05 05 05 05 05 05 05 05 05 05 05 05 05 05 05 05 05 05 05 05 05 05 05 05 05 05 05 05 05 05 35 39 39 39 39 39 39 35 05 05 05 05 05
05 05 05 05 05 05 05 05 05 05 05 05 05 05 05 05 05 05 05 05 05 05 05 05 05 05 05 05 05 05 05 05 05 05 05 05 05 05 05 05 05 05 35 39 39 39 39 39 39 35 05 05 05 05 05
05 05 05 05 05 05 05 05 05 05 05 05 05 05 05 05 05 05 05 05 05 05 05 05 05 05 05 05 05 05 05 05 05 05 05 05 05 05 05 05 05 05 35 39 39 39 39 39 39 35 05 05 05 05 05
05 05 05 05 35 35 35 35 35 35 35 35 35 35 35 35 35 35 35 35 35 35 35 35 35 35 35 35 05 05 05 05 05 05 05 05 05 05 05 05 05 05 35 39 39 39 39 39 39 35 05 05 05 05 05
05 05 05 05 35 39 39 39 39 39 39 39 39 39 39 39 39 39 39 39 39 39 39 39 39 39 39 35 05 05 05 05 05 05 05 05 05 05 05 05 05 05 35 39 39 39 39 39 39 35 05 05 05 05 05
05 05 05 05 35 39 39 39 39 39 39 39 39 39 39 39 39 39 39 39 39 39 39 39 39 39 39 35 05 05 05 05 05 05 05 05 05 05 05 05 05 05 35 39 39 39 39 39 39 35 05 05 05 05 05
05 05 05 05 35 39 39 39 39 39 39 39 39 39 39 39 39 39 39 39 39 39 39 39 39 39 39 35 05 05 05 05 05 05 05 05 05 05 05 05 05 05 35 39 39 39 39 39 39 35 05 05 05 05 05
05 05 05 05 35 39 39 39 39 39 39 39 39 39 39 39 39 39 39 39 39 39 39 39 39 39 39 35 05 05 05 05 05 05 05 05 05 05 05 05 05 05 35 39 39 39 39 39 39 35 05 05 05 05 05
05 05 05 05 35 39 39 39 39 39 39 39 39 39 39 39 39 39 39 39 39 39 39 39 39 39 39 35 05 05 05 05 05 05 05 05 05 05 05 05 05 05 35 39 39 39 39 39 39 35 05 05 05 05 05
05 05 05 05 35 39 39 39 39 39 39 39 39 39 39 39 39 39 39 39 39 39 39 39 39 39 39 35 05 05 05 05 05 05 05 05 05 05 05 05 05 05 35 39 39 39 39 39 39 35 05 05 05 05 05
05 05 05 05 35 39 39 39 39 39 39 39 39 39 39 39 39 39 39 39 39 39 39 39 39 39 39 35 35 35 35 35 35 35 35 35 35 35 35 35 35 35 35 39 39 39 39 39 39 35 05 05 05 05 05
05 05 05 05 35 39 39 39 39 39 39 39 39 39 39 39 39 39 39 39 39 39 39 39 39 39 39 39 39 39 39 39 39 39 39 39 39 39 39 39 39 39 39 39 39 39 39 39 39 35 05 05 05 05 05
05 05 05 05 35 39 39 39 39 39 39 39 39 39 39 39 39 39 39 39 39 39 39 39 39 39 39 39 39 39 39 39 39 39 39 39 39 39 39 39 39 39 39 39 39 39 39 39 39 35 05 05 05 05 05
05 05 05 05 35 39 39 39 39 35 35 35 35 35 35 35 35 35 35 35 35 35 35 35 35 35 35 35 35 35 35 35 35 35 35 35 35 35 35 35 35 35 39 39 39 39 39 39 39 35 05 05 05 05 05
05 05 05 05 35 39 39 39 39 35 05 05 05 05 05 05 05 05 05 05 05 05 05 05 05 05 05 05 05 05 05 05 05 05 05 05 05 05 05 05 05 05 39 39 39 39 39 39 39 39 05 05 05 05 05
05 05 05 05 35 39 39 39 39 35 05 05 05 05 05 05 05 05 05 05 05 05 05 05 05 05 05 05 05 05 05 05 05 05 05 05 05 05 05 05 05 05 39 39 39 39 39 39 39 39 05 05 05 05 05
05 05 05 05 35 39 39 39 39 35 05 05 05 05 05 05 05 05 05 05 05 05 05 05 05 05 05 05 05 05 05 05 05 05 05 05 05 05 05 05 05 05 39 39 39 39 39 39 39 39 05 05 05 05 05
05 05 05 05 35 39 39 39 39 35 05 05 05 05 05 05 05 05 05 05 05 05 05 05 05 05 05 05 05 05 05 05 05 05 05 05 05 05 05 05 05 05 39 39 39 39 39 39 39 39 05 05 05 05 05
05 05 05 05 35 39 39 39 39 35 05 05 05 05 05 05 05 05 05 05 05 05 05 05 05 05 05 05 05 05 05 05 05 05 05 05 05 05 05 05 05 05 39 39 39 39 39 39 39 39 05 05 05 05 05
05 05 05 05 35 39 39 39 39 35 05 05 05 05 05 05 05 05 05 05 05 05 05 05 05 05 05 05 35 35 35 35 35 35 35 35 35 35 35 05 05 05 54 39 39 39 39 39 39 39 05 05 05 05 05
05 05 05 05 35 39 39 39 39 35 05 05 05 05 05 05 05 05 05 05 05 05 05 05 05 05 05 05 35 50 50 50 50 50 50 50 50 50 35 05 05 05 38 32 39 39 39 39 39 39 05 05 05 05 05
05 05 05 05 35 39 39 39 39 35 05 05 05 05 05 05 05 05 05 05 05 05 05 05 05 05 05 05 35 51 51 51 51 51 51 51 51 51 35 05 05 05 33 34 39 39 39 39 39 85 05 05 05 05 05
05 05 05 05 35 39 39 39 39 35 05 05 05 05 05 05 05 05 05 05 05 05 05 05 05 05 05 05 35 55 55 55 55 55 55 55 55 55 35 05 05 05 36 39 37 37 37 37 37 84 05 05 05 05 05
05 05 05 05 35 39 39 39 39 35 05 05 05 05 05 05 05 05 05 05 05 05 05 05 05 05 05 05 35 39 39 39 39 37 39 39 39 39 35 05 05 05 05 05 05 05 05 05 05 05 05 05 05 05 05
05 05 05 05 35 39 39 39 39 35 05 05 05 05 05 05 05 05 05 05 05 05 05 05 05 05 05 05 35 39 39 46 47 39 39 46 47 39 35 05 05 05 05 05 05 05 05 05 05 05 05 05 05 05 05
05 05 05 05 35 39 39 39 39 35 05 05 05 05 05 05 05 05 05 05 05 05 05 05 05 05 05 05 35 39 39 49 48 39 39 49 48 39 35 05 05 05 05 05 05 05 05 05 05 05 05 05 05 05 05
05 05 05 05 35 39 39 39 39 35 05 05 05 05 05 05 05 05 05 05 05 05 05 05 05 05 05 05 35 39 39 39 39 39 39 39 39 39 35 05 05 05 05 05 05 05 05 05 05 05 05 05 05 05 05
05 05 05 05 35 39 39 39 39 35 05 05 05 05 05 05 05 05 05 05 05 05 05 05 05 05 05 05 35 39 39 39 39 39 39 39 39 39 35 05 05 05 05 05 05 05 05 05 05 05 05 05 05 05 05
05 05 05 05 35 39 39 39 39 35 35 35 35 35 35 35 35 35 35 35 35 35 35 35 35 35 35 35 35 39 39 39 39 39 39 39 39 39 35 35 35 35 35 35 35 35 35 35 35 35 35 35 05 05 05
05 05 05 05 35 50 39 39 39 39 39 39 39 39 39 39 39 39 39 39 39 39 39 39 39 39 39 39 39 39 39 39 39 39 39 39 39 39 39 39 46 47 39 39 39 39 54 39 39 39 53 35 05 05 05
05 05 05 05 35 51 39 39 39 39 39 39 39 39 39 39 39 39 39 39 39 39 39 39 39 39 39 39 39 39 39 39 39 39 39 39 39 39 39 39 49 48 39 39 39 39 39 39 39 39 52 35 05 05 05
05 05 05 05 35 39 39 39 39 39 39 39 39 39 39 39 39 39 39 39 39 39 39 39 39 39 39 39 39 39 39 39 39 39 39 39 39 39 39 39 39 39 39 39 39 39 39 56 39 39 39 35 05 05 05
05 05 05 05 35 39 39 39 39 39 39 39 39 39 39 39 39 39 39 39 39 39 39 39 39 39 39 39 39 39 39 39 39 39 39 39 39 39 40 41 39 39 39 39 39 39 39 37 39 39 39 35 05 05 05
05 05 05 05 35 39 39 39 39 39 39 39 39 39 39 39 39 39 39 39 39 39 39 39 39 39 39 39 39 39 39 39 39 39 39 39 39 39 42 43 39 39 39 39 39 39 39 39 39 39 39 35 05 05 05
05 05 05 05 35 39 39 39 39 39 39 39 39 39 39 39 39 39 39 39 39 39 39 39 39 39 39 39 39 39 39 39 39 39 39 39 39 39 44 45 39 39 39 39 39 39 39 39 39 39 39 35 05 05 05
05 05 05 05 35 39 39 39 39 39 39 39 39 39 39 39 39 39 39 39 39 39 39 39 39 39 39 39 39 39 39 39 39 39 39 39 39 39 39 39 39 39 39 39 39 39 39 39 39 39 39 35 05 05 05
05 05 05 05 35 39 39 39 39 39 39 39 39 39 39 39 39 39 39 39 39 39 39 39 39 39 39 39 39 39 39 39 39 39 39 39 39 39 39 39 39 39 39 39 39 39 39 39 39 39 39 35 05 05 05
05 05 05 05 35 39 39 39 39 39 39 39 39 39 39 39 39 39 39 39 39 39 39 39 39 39 39 39 39 39 39 39 39 39 39 39 39 39 39 39 39 39 39 39 39 39 39 39 39 39 39 35 05 05 05
05 05 05 05 35 50 39 39 39 39 39 39 39 39 39 39 39 39 39 39 39 39 39 39 39 39 39 39 39 39 39 39 39 39 39 39 39 39 39 39 39 39 39 39 39 39 39 39 39 39 39 35 05 05 05
05 05 05 05 35 51 39 39 39 39 39 39 39 39 39 39 39 39 39 39 39 39 39 39 39 39 39 39 39 39 39 39 39 39 39 39 39 39 39 39 39 39 39 39 39 39 39 39 39 39 39 35 05 05 05
05 05 05 05 35 35 35 35 35 35 35 35 35 35 35 35 35 35 35 35 35 35 35 35 35 35 35 35 35 35 35 35 35 35 35 35 35 35 35 35 35 35 35 35 35 35 35 35 35 35 35 35 05 05 05
05 05 05 05 05 05 05 05 05 05 05 05 05 05 05 05 05 05 05 05 05 05 05 05 05 05 05 05 05 05 05 05 05 05 05 05 05 05 05 05 05 05 05 05 05 05 05 05 05 05 05 05 05 05 05
05 05 05 05 05 05 05 05 05 05 05 05 05 05 05 05 05 05 05 05 05 05 05 05 05 05 05 05 05 05 05 05 05 05 05 05 05 05 05 05 05 05 05 05 05 05 05 05 05 05 05 05 05 05 05
05 05 05 05 05 05 05 05 05 05 05 05 05 05 05 05 05 05 05 05 05 05 05 05 05 05 05 05 05 05 05 05 05 05 05 05 05 05 05 05 05 05 05 05 05 05 05 05 05 05 05 05 05 05 05
05 05 05 05 05 05 05 05 05 05 05 05 05 05 05 05 05 05 05 05 05 05 05 05 05 05 05 05 05 05 05 05 05 05 05 05 05 05 05 05 05 05 05 05 05 05 05 05 05 05 05 05 05 05 05
